######
#@...#
#...Q#
#...k#
######