########
#@.....#
#.....k#
#.....k#
########